000002020000020200000
022222022222220222220
020000000000000000020
220222020222020222022
000000020000020000000
220222020222020222022
020260000000000062020
020202220222022202020
020002000000000200020
020202022222020202020
020000021110020000020
020202022222020202020
020002000666000200020
020202220222022202020
020260000000000062020
220222020222020222022
000000020000020000000
220222020222020222022
020000000300000000020
022222022222220222220
000002020000020200000