222222022222220222222
222222022222220222222
221000000000000000122
220222020222020222022
000000020000020000000
220222020222020222022
220260000000000062022
220202220222022202022
220002000202000200022
220202020222020202022
220000020000020000022
220202020222020202022
220002000202000200022
220202220222022202022
220260000000000062022
220222020222020222022
000000020000020000000
220222020222020222022
220000000300000000022
222222022222220222222
222222022222220222222