
2222220222222222222222222222220222222
2222220222222222222222222222220222222
2200600000600000600060000060000060022
2202220262226202220222026222620222022
2200600200600200600060020060020060022
2202220202220202220222020222020222022
2262600000600000626260000060000062622
2202022262226222020202226222622202022
0000020002020002000002000202000200000
2202020202220202020202020222020202022
2200006200000260000000620000026000022
2202020202220202020202020222020202022
0000020002020002000002000202000200000
2202022262226222020202226222622202022
2262000000600000026200000060000002622
2202226202220262220222620222026222022
2200600200600200600060020060020060022
2202220202220202220222020222020222022
2200600000600000603060000060000060022
2202220262226202220222026222620222022
2200600200600200600060020060020060022
2202220202220202220222020222020222022
2262600000600000626260000060000062622
2202022262226222020202226222622202022
0000020002020002000002000202000200000
2202020202220202020202020222020202022
2200006200000260000000620000026000022
2202020202220202020202020222020202022
0000020002020002000002000202000200000
2202022262226222020202226222622202022
2262000000600000026200000060000002622
2202226202220262220222620222026222022
2200600200600200600060020060020060022
2202220202220202220222020222020222022
2200600000600000600060000060000060022
2222220222222222222222222222220222222
2222220222222222222222222222220222222