2222220222222202222222222222222222222202222222022222222222222222222222222222022222022222222
2222220222222202222222222222222222222202222222022222222222222222222222222222022222022222222
0000600000600000600060000060000060006000006000006000600000600100600060000060000060006000000
2202220262226202220222026222620222022202622262022202220262226202220222026222620222022202622
0200600200600200600060020060020060006002006002006000600200600200600060020060020060006002020
0202220202220202220222020222020222022202022202022202220202220202220222020222020222022202020
0262600000600000626260000060000062626000006000006262600000600000626260000060000062626000020
0202022262226222020202226222622202020222622262220202022262226222020202226222622202020222620
0200020002020002000002000202000200000200020200020000020002020002000002000202000200000200020
0202020202220202020202020222020202020202022202020202020202220202020202020222020202020202020
0200006200000260000000620000026000000062000002600000006200000260000000620000026000000062020
0202020202220202020202020222020202020202022202020202020202220202020202020222020202020202020
0200020002020002000002000202000200000200020200020000020002020002000002000202000200000200020
0202022262226222020202226222622202020222622262220202022262226222020202226222622202020222620
0262000000600100026200000060000002620000006000000262000000600000026200000060000002620000020
0202226202220262220222620222026222022262022202622202226202220262220222620222026222022262020
0200600200600200600060020060020060006002006002006000600200600200600060020060020060006002020
2202220202220202220222020222020222022202022202022202220202220202220222020222020222022202022
0000600000600000600060000060000060006000006000006000600000600000600060100060000060006000000
2202220262226202220222026222620222022202622262022202220262226202220222026222620222022202622
0200600200600200600060020060020060006002006002006000600200600200600060020060020060006002020
0202220202220202220222020222020222022202022202022202220202220202220222020222020222022202020
0262600000600000626260000060000062626000006000006262600000600000626260000060000062626000020
0202022262226222020202226222622202020222622262220202022262226222020202226222622202020222620
0200020002020002000002000202000200000200020200020000020002020002000002000202000200000200020
0202020202220202020202020222020202020202022202020202020202220202020202020222020202020202020
0200006200000260000000620010026000000062000002600000006200000260000000620000026000000062020
0202020202220202020202020222020202020202022202020202020202220202020202020222020202020202020
0200020002020002000002000202000200000200020200020000020002020002000002000202000200000200020
0202022262226222020202226222622202020222622262220202022262226222020202226222622202020222620
0262000000600000026200000060000002620000006000000262000000600000026200000060000002620000020
0202226202220262220222620222026222022262022202622202226202220262220222620222026222022262020
0200600200600200600060020060020060006002006002006000600200600200600060020060020060006002020
0202220202220202220222020222020222022202022202022202220202220202220222020222020222022202020
0200600000600000600060000060000060006000006000000300600000600000600060000060000060006000020
0202220262226202220222026222620222022202622262022202220262226202220222026222620222022202620
0200600200600200600060020060020060006002006002006000600200600200600060020060020060006002020
0202220202220202220222020222020222022202022202022202220202220202220222020222020222022202020
0262600000600000626260000060000062626000006000006262600000600000626260000060000062626000020
0202022262226222020202226222622202020222622262220202022262226222020202226222622202020222620
0200020102020002000002000202000200000200020200020000020002020002000002000202000200000200020
0202020202220202020202020222020202020202022202020202020202220202020202020222020202020202020
0200006200000260000000620000026000000062000002600000006200000260000000620000026000000062020
0202020202220202020202020222020202020202022202020202020202220202020202020222020202020202020
0200020002020002000002000202000200000201020200020000020002020002000002000202000200000200020
0202022262226222020202226222622202020222622262220202022262226222020202226222622202020222620
0262000000600000026200000060000002620000006000000262000000600000026200000060000002620000020
0202226202220262220222620222026222022262022202622202226202220262220222620222026222022262020
0200600200600200600060020060020060006002006002006000600200600200600060020060020060006002020
2202220202220202220222020222020222022202022202022202220202220202220222020222020222022202022
0000600000600000600060000060000060006000006000006000600000600000600060010060000060006000000
2202220262226202220222026222620222022202622262022202220262226202220222026222620222022202622
0200600200600200600060020060020060006002006002006000600200600200600060020060020060006002020
0202220202220202220222020222020222022202022202022202220202220202220222020222020222022202020
0262600000600000626260000060000062626000006000006262600000600000626260000060000062626000020
0202022262226222020202226222622202020222622262220202022262226222020202226222622202020222620
0200020002020002000002000202000200000200020200020000020002020002000002000202000200000200020
0202020202220202020202020222020202020202022202020202020202220202020202020222020202020202020
0200006200000260000000620000026000000062000002600000006200000260000000620000026000000062020
0202020202220202020202020222020202020202022202020202020202220202020202020222020202020202020
0200020002020002000002000202000200000200020200020000020002020002000002000202000200000200020
0202022262226222020202226222622202020222622262220202022262226222020202226222622202020222620
0262000000600000026200000060000002620000006000000262000000601000026200000060000002620000020
0202226202220262220222620222026222022262022202622202226202220262220222620222026222022262020
0200600200600200600060020060020060006002006002006000600200600200600060020060020060006002020
2202221202220202220222020222020222022202022202022202220202220202220222020222020222022202022
0000600000600000600060000060000060006000006010006000600000600000600060000060000060006000000
2222220222222202222222222222222222222202222222022222222222222222222222222222022222022222222
2222220222222202222222222222222222222202222222022222222222222222222222222222022222022222222