1111111111111111111
1006000006000006001
1022202622262022201
1006002006002006001
1022202022202022201
1626000006000006261
1020222622262220201
1000200020200020001
1020202022202020201
1000062034452600001
1020202022202020201
1000200020200020001
1020222622262220201
1620000006000000261
1022262022202622201
1006002006002006001
1022202022202022201
1006000006000006001
1111111111111111111