
11111111111111111111111111111111111
10060000060000060006000006000006001
10222026222620222022202622262022201
10060020060020060006002006002006001
10222020222020222022202022202022201
16260000060000062626000006000006261
10202226222622202020222622262220201
10002000202000200000200020200020001
10202020222020202020202022202020201
10000620000026000000062000002600001
10202020222020202020202022202020201
10002000202000200000200020200020001
10202226222622202020222622262220201
16200000060000002620000006000000261
10222620222026222022262022202622201
10060020060020060006002006002006001
10222020222020222022202022202022201
10060000060000063456000006000006001
10222026222620222022202622262022201
10060020060020060006002006002006001
10222020222020222022202022202022201
16260000060000062626000006000006261
10202226222622202020222622262220201
10002000202000200000200020200020001
10202020222020202020202022202020201
10000620000026000000062000002600001
10202020222020202020202022202020201
10002000202000200000200020200020001
10202226222622202020222622262220201
16200000060000002620000006000000261
10222620222026222022262022202622201
10060020060020060006002006002006001
10222020222020222022202022202022201
10060000060000060006000006000006001
11111111111111111111111111111111111