1111111111111111111
1000000000000000001
1022202022202022201
1000002000002000001
1022202022202022201
1026000000000006201
1020222022202220201
1000200020200020001
1020202022202020201
1000002000002000001
1020202022202020201
1000200020200020001
1020222022202220201
1026000000000006201
1022202022202022201
1000002000002000001
1022202022202022201
1000000034450000001
1111111111111111111