
111111111111111111111111111111111111111111111111111111111111111111111111111111111111111111111111111
100600000600000600060000060000060006000006000006000600000600000600060000060000060006000006000006001
102220262226202220222026222620222022202622262022202220262226202220222026222620222022202622262022201
100600200600200600060020060020060006002006002006000600200600200600060020060020060006002006002006001
102220202220202220222020222020222022202022202022202220202220202220222020222020222022202022202022201
162600000600000626260000060000062626000006000006262600000600000626260000060000062626000006000006261
102022262226222020202226222622202020222622262220202022262226222020202226222622202020222622262220201
100020002020002000002000202000200000200020200020000020002020002000002000202000200000200020200020001
102020202220202020202020222020202020202022202020202020202220202020202020222020202020202022202020201
100006200000260000000620000026000000062000002600000006200000260000000620000026000000062000002600001
102020202220202020202020222020202020202022202020202020202220202020202020222020202020202022202020201
100020002020002000002000202000200000200020200020000020002020002000002000202000200000200020200020001
102022262226222020202226222622202020222622262220202022262226222020202226222622202020222622262220201
162000000600000026200000060000002620000006000000262000000600000026200000060000002620000006000000261
102226202220262220222620222026222022262022202622202226202220262220222620222026222022262022202622201
100600200600200600060020060020060006002006002006000600200600200600060020060020060006002006002006001
102220202220202220222020222020222022202022202022202220202220202220222020222020222022202022202022201
100600000600000600060000060000060006000006000006000600000600000600060000060000060006000006000006001
102220262226202220222026222620222022202622262022202220262226202220222026222620222022202622262022201
100600200600200600060020060020060006002006002006000600200600200600060020060020060006002006002006001
102220202220202220222020222020222022202022202022202220202220202220222020222020222022202022202022201
162600000600000626260000060000062626000006000006262600000600000626260000060000062626000006000006261
102022262226222020202226222622202020222622262220202022262226222020202226222622202020222622262220201
100020002020002000002000202000200000200020200020000020002020002000002000202000200000200020200020001
102020202220202020202020222020202020202022202020202020202220202020202020222020202020202022202020201
100006200000260000000620000026000000062000002600000006200000260000000620000026000000062000002600001
102020202220202020202020222020202020202022202020202020202220202020202020222020202020202022202020201
100020002020002000002000202000200000200020200020000020002020002000002000202000200000200020200020001
102022262226222020202226222622202020222622262220202022262226222020202226222622202020222622262220201
162000000600000026200000060000002620000006000000262000000600000026200000060000002620000006000000261
102226202220262220222620222026222022262022202622202226202220262220222620222026222022262022202622201
100600200600200600060020060020060006002006002006000600200600200600060020060020060006002006002006001
102220202220202220222020222020222022202022202022202220202220202220222020222020222022202022202022201
100600000600000600060000060000060006000006000034450600000600000600060000060000060006000006000006001
102220262226202220222026222620222022202622262022202220262226202220222026222620222022202622262022201
100600200600200600060020060020060006002006002006000600200600200600060020060020060006002006002006001
102220202220202220222020222020222022202022202022202220202220202220222020222020222022202022202022201
162600000600000626260000060000062626000006000006262600000600000626260000060000062626000006000006261
102022262226222020202226222622202020222622262220202022262226222020202226222622202020222622262220201
100020002020002000002000202000200000200020200020000020002020002000002000202000200000200020200020001
102020202220202020202020222020202020202022202020202020202220202020202020222020202020202022202020201
100006200000260000000620000026000000062000002600000006200000260000000620000026000000062000002600001
102020202220202020202020222020202020202022202020202020202220202020202020222020202020202022202020201
100020002020002000002000202000200000200020200020000020002020002000002000202000200000200020200020001
102022262226222020202226222622202020222622262220202022262226222020202226222622202020222622262220201
162000000600000026200000060000002620000006000000262000000600000026200000060000002620000006000000261
102226202220262220222620222026222022262022202622202226202220262220222620222026222022262022202622201
100600200600200600060020060020060006002006002006000600200600200600060020060020060006002006002006001
102220202220202220222020222020222022202022202022202220202220202220222020222020222022202022202022201
100600000600000600060000060000060006000006000006000600000600000600060000060000060006000006000006001
102220262226202220222026222620222022202622262022202220262226202220222026222620222022202622262022201
100600200600200600060020060020060006002006002006000600200600200600060020060020060006002006002006001
102220202220202220222020222020222022202022202022202220202220202220222020222020222022202022202022201
162600000600000626260000060000062626000006000006262600000600000626260000060000062626000006000006261
102022262226222020202226222622202020222622262220202022262226222020202226222622202020222622262220201
100020002020002000002000202000200000200020200020000020002020002000002000202000200000200020200020001
102020202220202020202020222020202020202022202020202020202220202020202020222020202020202022202020201
100006200000260000000620000026000000062000002600000006200000260000000620000026000000062000002600001
102020202220202020202020222020202020202022202020202020202220202020202020222020202020202022202020201
100020002020002000002000202000200000200020200020000020002020002000002000202000200000200020200020001
102022262226222020202226222622202020222622262220202022262226222020202226222622202020222622262220201
162000000600000026200000060000002620000006000000262000000600000026200000060000002620000006000000261
102226202220262220222620222026222022262022202622202226202220262220222620222026222022262022202622201
100600200600200600060020060020060006002006002006000600200600200600060020060020060006002006002006001
102220202220202220222020222020222022202022202022202220202220202220222020222020222022202022202022201
100600000600000600060000060000060006000006000006000600000600000600060000060000060006000006000006001
111111111111111111111111111111111111111111111111111111111111111111111111111111111111111111111111111