
11111111111111111111111111111111111111111111111111111111111111111111111111111111111111111
10060000060000060006000006000006000600000600000600060000060000060006000006000006000600001
10222026222620222022202622262022202220262226202220222026222620222022202622262022202220261
10060020060020060006002006002006000600200600200600060020060020060006002006002006000600201
10222020222020222022202022202022202220202220202220222020222020222022202022202022202220201
16260000060000062626000006000006262600000600000626260000060000062626000006000006262600001
10202226222622202020222622262220202022262226222020202226222622202020222622262220202022261
10002000202000200000200020200020000020002020002000002000202000200000200020200020000020001
10202020222020202020202022202020202020202220202020202020222020202020202022202020202020201
10000620000026000000062000002600000006200000260000000620000026000000062000002600000006201
10202020222020202020202022202020202020202220202020202020222020202020202022202020202020201
10002000202000200000200020200020000020002020002000002000202000200000200020200020000020001
10202226222622202020222622262220202022262226222020202226222622202020222622262220202022261
16200000060000002620000006000000262000000600000026200000060000002620000006000000262000001
10222620222026222022262022202622202226202220262220222620222026222022262022202622202226201
10060020060020060006002006002006000600200600200600060020060020060006002006002006000600201
10222020222020222022202022202022202220202220202220222020222020222022202022202022202220201
10060000060000060006000006000006000600000600000600060000060000060006000006000006000600001
10222026222620222022202622262022202220262226202220222026222620222022202622262022202220261
10060020060020060006002006002006000600200600200600060020060020060006002006002006000600201
10222020222020222022202022202022202220202220202220222020222020222022202022202022202220201
16260000060000062626000006000006262600000600000626260000060000062626000006000006262600001
10202226222622202020222622262220202022262226222020202226222622202020222622262220202022261
10002000202000200000200020200020000020002020002000002000202000200000200020200020000020001
10202020222020202020202022202020202020202220202020202020222020202020202022202020202020201
10000620000026000000062000002600000006200000260000000620000026000000062000002600000006201
10202020222020202020202022202020202020202220202020202020222020202020202022202020202020201
10002000202000200000200020200020000020002020002000002000202000200000200020200020000020001
10202226222622202020222622262220202022262226222020202226222622202020222622262220202022261
16200000060000002620000006000000262000000600000026200000060000002620000006000000262000001
10222620222026222022262022202622202226202220262220222620222026222022262022202622202226201
10060020060020060006002006002006000600200600200600060020060020060006002006002006000600201
10222020222020222022202022202022202220202220202220222020222020222022202022202022202220201
10060000060000060006000006000006000600000600003445060000060000060006000006000006000600001
10222026222620222022202622262022202220262226202220222026222620222022202622262022202220261
10060020060020060006002006002006000600200600200600060020060020060006002006002006000600201
10222020222020222022202022202022202220202220202220222020222020222022202022202022202220201
16260000060000062626000006000006262600000600000626260000060000062626000006000006262600001
10202226222622202020222622262220202022262226222020202226222622202020222622262220202022261
10002000202000200000200020200020000020002020002000002000202000200000200020200020000020001
10202020222020202020202022202020202020202220202020202020222020202020202022202020202020201
10000620000026000000062000002600000006200000260000000620000026000000062000002600000006201
10202020222020202020202022202020202020202220202020202020222020202020202022202020202020201
10002000202000200000200020200020000020002020002000002000202000200000200020200020000020001
10202226222622202020222622262220202022262226222020202226222622202020222622262220202022261
16200000060000002620000006000000262000000600000026200000060000002620000006000000262000001
10222620222026222022262022202622202226202220262220222620222026222022262022202622202226201
10060020060020060006002006002006000600200600200600060020060020060006002006002006000600201
10222020222020222022202022202022202220202220202220222020222020222022202022202022202220201
10060000060000060006000006000006000600000600000600060000060000060006000006000006000600001
10222026222620222022202622262022202220262226202220222026222620222022202622262022202220261
10060020060020060006002006002006000600200600200600060020060020060006002006002006000600201
10222020222020222022202022202022202220202220202220222020222020222022202022202022202220201
16260000060000062626000006000006262600000600000626260000060000062626000006000006262600001
10202226222622202020222622262220202022262226222020202226222622202020222622262220202022261
10002000202000200000200020200020000020002020002000002000202000200000200020200020000020001
10202020222020202020202022202020202020202220202020202020222020202020202022202020202020201
10000620000026000000062000002600000006200000260000000620000026000000062000002600000006201
10202020222020202020202022202020202020202220202020202020222020202020202022202020202020201
10002000202000200000200020200020000020002020002000002000202000200000200020200020000020001
10202226222622202020222622262220202022262226222020202226222622202020222622262220202022261
16200000060000002620000006000000262000000600000026200000060000002620000006000000262000001
10222620222026222022262022202622202226202220262220222620222026222022262022202622202226201
10060020060020060006002006002006000600200600200600060020060020060006002006002006000600201
10222020222020222022202022202022202220202220202220222020222020222022202022202022202220201
10060000060000060006000006000006000600000600000600060000060000060006000006000006000600001
11111111111111111111111111111111111111111111111111111111111111111111111111111111111111111